   ##   ###   ##  #    #  ### 
# # #     ###   ##   ##### ## 
# #  #  #        ######## #  #
  # ## #  # # ### # ## # # ###
    # ## ##    #####  #B ##   
 # ## # #  ##  ##        ## ##
## ###  #  ## # #   # ### ### 
     ##  ###A# ##  # #   # # #
#    #  # #  ## ### ### # #  #
##  ##       ## #### #   #  # 
 ##     ###  #     # #  #  #  
   ## #### #  #  ## ###  ###  
#####   ##  ##  # # #####    #
 #  ### ## ####     ## ###  # 
# ##   ######  #   ###### ##  
#  # ## ##   ### # #####    ##
   # # ####      #  ###### #  
   ###  # #  ## #  ####  ##   
##  # # ### ### # # # # ###   
 # # ### # # # # #####   # ## 
 #    #### #### # ##  #  ## # 
  # ##  ### ##  ##### ##  ####
##  # # #   ###  #### #### ## 
 ##   ### # # ### #  ####  #  
### ##    # ## #   #####   # #
# #### ## ###### #  # # #   ##
#  ##    # ## #### # # # ##  #
# ### # #### ### #  #   #    #
  ### ##  ## ## # ## ###      
     ### ###   #  #      ## ##
