## ##  #### ###  #  
     # # #  #  ## ##
# # ##B  # # ##    #
#A # #  #  ##  ## ##
## ## # #### #      
 ######  #     # ###
# ###    ##  ## ##  
  # ### ###  ## ####
 #  ##   #     ### #
    ##    ## # ##   
   ### ## ##### ## #
 # #   #      # ### 
 # ## #   ## #    ##
## ###  #  #####  ##
#####   ##  ###   # 
##      ##    #  ## 
 # ## # #   ## ##   
     # # # #  #  # #
###  # ####   ######
## #    # ##   #    
